"","date","cases","deaths","cum_cases","cum_deaths","p_cases","p_cases_daily","p_cases_active","population"
"1","2020/03/21",3,0,3,0,1.11237567625952e-07,1.11237567625952e-07,1.11237567625952e-07,26969306
"2","2020/03/22",0,0,3,0,1.11237567625952e-07,0,1.11237567625952e-07,26969306
"3","2020/03/23",0,0,3,0,1.11237567625952e-07,0,1.11237567625952e-07,26969306
"4","2020/03/24",14,0,17,0,6.30346216547063e-07,5.1910864892111e-07,6.30346216547063e-07,26969306
"5","2020/03/25",2,0,19,0,7.04504594964364e-07,7.41583784173015e-08,7.04504594964364e-07,26969306
"6","2020/03/26",0,0,19,0,7.04504594964364e-07,0,7.04504594964364e-07,26969306
"7","2020/03/27",4,0,23,0,8.52821351798967e-07,1.48316756834603e-07,8.52821351798967e-07,26969306
"8","2020/03/28",1,0,24,0,8.89900541007618e-07,3.70791892086508e-08,8.89900541007618e-07,26969306
"9","2020/03/29",4,0,28,0,1.03821729784222e-06,1.48316756834603e-07,1.03821729784222e-06,26969306
"10","2020/03/30",9,0,37,0,1.37193000072008e-06,3.33712702877857e-07,1.37193000072008e-06,26969306
"11","2020/03/31",7,0,44,0,1.63148432518063e-06,2.59554324460555e-07,1.63148432518063e-06,26969306
"12","2020/04/01",2,0,46,0,1.70564270359793e-06,7.41583784173015e-08,1.70564270359793e-06,26969306
"13","2020/04/02",8,0,54,0,2.00227621726714e-06,2.96633513669206e-07,1.89103864964119e-06,26969306
"14","2020/04/03",5,0,59,0,2.18767216331039e-06,1.85395946043254e-07,2.07643459568444e-06,26969306
"15","2020/04/04",6,0,65,0,2.4101472985623e-06,2.22475135251905e-07,2.29890973093635e-06,26969306
"16","2020/04/05",6,0,71,0,2.6326224338142e-06,2.22475135251905e-07,2.00227621726714e-06,26969306
"17","2020/04/06",1,0,72,0,2.66970162302285e-06,3.70791892086508e-08,1.96519702805849e-06,26969306
"18","2020/04/07",5,0,77,0,2.85509756906611e-06,1.85395946043254e-07,2.15059297410174e-06,26969306
"19","2020/04/08",8,0,85,0,3.15173108273531e-06,2.96633513669206e-07,2.29890973093635e-06,26969306
"20","2020/04/09",8,0,93,0,3.44836459640452e-06,2.96633513669206e-07,2.5584640553969e-06,26969306
"21","2020/04/10",0,0,93,0,3.44836459640452e-06,0,2.4101472985623e-06,26969306
"22","2020/04/11",9,0,102,0,3.78207729928238e-06,3.33712702877857e-07,2.4101472985623e-06,26969306
"23","2020/04/12",0,0,102,0,3.78207729928238e-06,0,2.15059297410174e-06,26969306
"24","2020/04/13",4,0,106,0,3.93039405611698e-06,1.48316756834603e-07,2.22475135251905e-06,26969306
"25","2020/04/14",0,0,106,0,3.93039405611698e-06,0,1.92811783884984e-06,26969306
"26","2020/04/15",2,0,108,0,4.00455243453428e-06,7.41583784173015e-08,1.81688027122389e-06,26969306
"27","2020/04/16",2,0,110,0,4.07871081295158e-06,7.41583784173015e-08,1.66856351438928e-06,26969306
"28","2020/04/17",1,0,111,0,4.11579000216023e-06,3.70791892086508e-08,1.48316756834603e-06,26969306
"29","2020/04/18",6,0,117,0,4.33826513741214e-06,2.22475135251905e-07,1.66856351438928e-06,26969306
"30","2020/04/19",0,0,117,0,4.33826513741214e-06,0,1.48316756834603e-06,26969306
"31","2020/04/20",4,0,121,0,4.48658189424674e-06,1.48316756834603e-07,1.33485081151143e-06,26969306
"32","2020/04/21",0,0,121,0,4.48658189424674e-06,0,1.03821729784222e-06,26969306
"33","2020/04/22",0,0,121,0,4.48658189424674e-06,0,1.03821729784222e-06,26969306
"34","2020/04/23",0,0,121,0,4.48658189424674e-06,0,7.04504594964364e-07,26969306
"35","2020/04/24",0,0,121,0,4.48658189424674e-06,0,7.04504594964364e-07,26969306
"36","2020/04/25",1,0,122,0,4.52366108345539e-06,3.70791892086508e-08,5.93267027338412e-07,26969306
"37","2020/04/26",2,0,124,0,4.59781946187269e-06,7.41583784173015e-08,6.67425405755714e-07,26969306
"38","2020/04/27",0,0,124,0,4.59781946187269e-06,0,5.93267027338412e-07,26969306
"39","2020/04/28",4,0,128,0,4.7461362187073e-06,1.48316756834603e-07,6.67425405755714e-07,26969306
"40","2020/04/29",0,0,128,0,4.7461362187073e-06,0,6.30346216547063e-07,26969306
"41","2020/04/30",0,0,128,0,4.7461362187073e-06,0,4.07871081295158e-07,26969306
"42","2020/05/01",4,0,132,0,4.8944529755419e-06,1.48316756834603e-07,5.56187838129761e-07,26969306
"43","2020/05/02",3,0,135,0,5.00569054316785e-06,1.11237567625952e-07,5.1910864892111e-07,26969306
"44","2020/05/03",0,0,135,0,5.00569054316785e-06,0,5.1910864892111e-07,26969306
"45","2020/05/04",14,0,149,0,5.52479919208896e-06,5.1910864892111e-07,1.03821729784222e-06,26969306
"46","2020/05/05",0,0,149,0,5.52479919208896e-06,0,1.03821729784222e-06,26969306
"47","2020/05/06",9,0,158,0,5.85851189496682e-06,3.33712702877857e-07,1.37193000072008e-06,26969306
"48","2020/05/07",0,0,158,0,5.85851189496682e-06,0,1.33485081151143e-06,26969306
"49","2020/05/08",11,0,169,0,6.26638297626198e-06,4.07871081295158e-07,1.66856351438928e-06,26969306
"50","2020/05/09",0,0,169,0,6.26638297626198e-06,0,1.66856351438928e-06,26969306
"51","2020/05/10",0,0,169,0,6.26638297626198e-06,0,1.52024675755468e-06,26969306
"52","2020/05/11",2,0,171,0,6.34054135467928e-06,7.41583784173015e-08,1.59440513597198e-06,26969306
"53","2020/05/12",15,0,186,0,6.89672919280904e-06,5.56187838129761e-07,2.15059297410174e-06,26969306
"54","2020/05/13",6,0,192,0,7.11920432806094e-06,2.22475135251905e-07,2.22475135251905e-06,26969306
"55","2020/05/14",20,0,212,0,7.86078811223396e-06,7.41583784173015e-07,2.85509756906611e-06,26969306
"56","2020/05/15",18,0,230,0,8.52821351798967e-06,6.67425405755714e-07,3.52252297482182e-06,26969306
"57","2020/05/16",8,0,238,0,8.82484703165888e-06,2.96633513669206e-07,3.30004783956992e-06,26969306
"58","2020/05/17",45,0,283,0,1.04934105460482e-05,1.66856351438928e-06,4.9686113539592e-06,26969306
"59","2020/05/18",21,1,304,1,1.12720735194298e-05,7.78662973381666e-07,5.41356162446301e-06,26969306
"60","2020/05/19",18,0,322,1,1.19394989251855e-05,6.67425405755714e-07,6.08098703021872e-06,26969306
"61","2020/05/20",4,1,326,2,1.20878156820201e-05,1.48316756834603e-07,5.82143270575817e-06,26969306
"62","2020/05/21",45,0,371,2,1.37563791964094e-05,1.66856351438928e-06,7.48999622014745e-06,26969306
"63","2020/05/22",34,0,405,2,1.50170716295036e-05,1.26069243309413e-06,8.75068865324158e-06,26969306
"64","2020/05/23",43,0,448,2,1.66114767654755e-05,1.59440513597198e-06,1.02709354107963e-05,26969306
"65","2020/05/24",0,0,448,2,1.66114767654755e-05,0,9.7147475726665e-06,26969306
"66","2020/05/25",79,0,527,2,1.95407327129589e-05,2.92925594748341e-06,1.2421528384898e-05,26969306
"67","2020/05/26",15,0,542,2,2.00969205510887e-05,5.56187838129761e-07,1.22361324388547e-05,26969306
"68","2020/05/27",44,0,586,2,2.17284048762693e-05,1.63148432518063e-06,1.32001913582797e-05,26969306
"69","2020/05/28",26,0,612,2,2.26924637956943e-05,9.6405891942492e-07,1.38676167640354e-05,26969306
"70","2020/05/29",44,0,656,2,2.43239481208749e-05,1.63148432518063e-06,1.38305375748267e-05,26969306
"71","2020/05/30",42,3,698,5,2.58812740676382e-05,1.55732594676333e-06,1.46092005482084e-05,26969306
"72","2020/05/31",60,1,758,6,2.81060254201573e-05,2.22475135251905e-06,1.61665264949717e-05,26969306
"73","2020/06/01",13,0,771,6,2.85880548798697e-05,4.8202945971246e-07,1.65002391978496e-05,26969306
"74","2020/06/02",55,0,826,6,3.06274102863455e-05,2.03935540647579e-06,1.68710310899361e-05,26969306
"75","2020/06/03",19,0,845,6,3.13319148813099e-05,7.04504594964364e-07,1.63148432518063e-05,26969306
"76","2020/06/04",63,0,908,6,3.36679038014549e-05,2.335988920145e-06,1.70564270359793e-05,26969306
"77","2020/06/05",49,1,957,7,3.54847840726788e-05,1.81688027122389e-06,1.88733073072032e-05,26969306
"78","2020/06/06",18,0,975,7,3.61522094784345e-05,6.67425405755714e-07,1.66114767654755e-05,26969306
"79","2020/06/07",51,1,1026,8,3.80432481280757e-05,1.89103864964119e-06,1.7946327576987e-05,26969306
"80","2020/06/08",26,1,1052,9,3.90073070475006e-05,9.6405891942492e-07,1.72789021712313e-05,26969306
"81","2020/06/09",42,0,1094,9,4.05646329942639e-05,1.55732594676333e-06,1.78721691985697e-05,26969306
"82","2020/06/10",44,0,1138,9,4.21961173194446e-05,1.63148432518063e-06,1.78721691985697e-05,26969306
"83","2020/06/11",24,1,1162,10,4.30860178604522e-05,8.89900541007618e-07,1.7204743792814e-05,26969306
"84","2020/06/12",41,0,1203,10,4.46062646180069e-05,1.52024675755468e-06,1.65002391978496e-05,26969306
"85","2020/06/13",27,0,1230,10,4.56074027266404e-05,1.00113810863357e-06,1.70193478467707e-05,26969306
"86","2020/06/14",22,0,1252,10,4.64231448892307e-05,8.15742162590317e-07,1.57957346028852e-05,26969306
"87","2020/06/15",20,0,1272,10,4.71647286734038e-05,7.41583784173015e-07,1.58328137920939e-05,26969306
"88","2020/06/16",18,0,1290,10,4.78321540791595e-05,6.67425405755714e-07,1.41642502777046e-05,26969306
"89","2020/06/17",27,2,1317,12,4.8833292187793e-05,1.00113810863357e-06,1.33485081151143e-05,26969306
"90","2020/06/18",61,0,1378,12,5.10951227295207e-05,2.2618305417277e-06,1.49429132510863e-05,26969306
"91","2020/06/19",25,1,1403,13,5.2022102459737e-05,9.26979730216269e-07,1.39788543316613e-05,26969306
"92","2020/06/20",40,0,1443,13,5.3505270028083e-05,1.48316756834603e-06,1.44979629805824e-05,26969306
"93","2020/06/21",60,0,1503,13,5.57300213806021e-05,2.22475135251905e-06,1.51653883863382e-05,26969306
"94","2020/06/22",93,1,1596,14,5.91783859770066e-05,3.44836459640452e-06,1.6982268657562e-05,26969306
"95","2020/06/23",44,1,1640,15,6.08098703021872e-05,1.63148432518063e-06,1.77238524417351e-05,26969306
"96","2020/06/24",84,0,1724,15,6.39245221957139e-05,3.11465189352666e-06,1.9318257577707e-05,26969306
"97","2020/06/25",63,1,1787,16,6.62605111158589e-05,2.335988920145e-06,2.06531083892185e-05,26969306
"98","2020/06/26",42,0,1829,16,6.78178370626222e-05,1.55732594676333e-06,2.13946921733915e-05,26969306
"99","2020/06/27",93,0,1922,16,7.12662016590267e-05,3.44836459640452e-06,2.4101472985623e-05,26969306
"100","2020/06/28",83,0,2005,16,7.43437743633448e-05,3.07757270431801e-06,2.65116202841853e-05,26969306
"101","2020/06/29",73,2,2078,18,7.70505551755763e-05,2.70678081223151e-06,2.82172629877832e-05,26969306
"102","2020/06/30",60,2,2138,20,7.92753065280953e-05,2.22475135251905e-06,2.81801837985746e-05,26969306
"103","2020/07/01",76,0,2214,20,8.20933249079528e-05,2.81801837985746e-06,3.00712224482158e-05,26969306
"104","2020/07/02",89,2,2303,22,8.53933727475227e-05,3.30004783956992e-06,3.18881027194396e-05,26969306
"105","2020/07/03",100,2,2403,24,8.91012916683878e-05,3.70791892086508e-06,3.33712702877857e-05,26969306
"106","2020/07/04",109,2,2512,26,9.31429232921307e-05,4.04163162374293e-06,3.39645373151241e-05,26969306
"107","2020/07/05",216,3,2728,29,0.000101152028161199,8.00910486906856e-06,4.0342157859012e-05,26969306
"108","2020/07/06",0,0,2728,29,0.000101152028161199,0,3.72275059654854e-05,26969306
"109","2020/07/07",522,4,3250,33,0.000120507364928115,1.93553367669157e-05,5.42468538122561e-05,26969306
"110","2020/07/08",222,0,3472,33,0.000128738944932435,8.23158000432047e-06,6.09211078698132e-05,26969306
"111","2020/07/09",101,0,3573,33,0.000132483943042509,3.74499811007373e-06,6.12177413834824e-05,26969306
"112","2020/07/10",209,0,3782,33,0.000140233493587117,7.74955054460801e-06,6.58897192237724e-05,26969306
"113","2020/07/11",361,1,4143,34,0.00015361908089144,1.33855873043229e-05,7.65685257158638e-05,26969306
"114","2020/07/12",435,0,4578,34,0.000169748528197203,1.61294473057631e-05,9.04732216691078e-05,26969306
"115","2020/07/13",289,1,4867,35,0.000180464413878503,1.07158856813001e-05,9.83710889705504e-05,26969306
"116","2020/07/14",213,2,5080,37,0.000188362281179946,7.89786730144261e-06,0.000102968908432423,26969306
"117","2020/07/15",263,2,5343,39,0.000198114107941821,9.75182676187515e-06,0.000109012816273433,26969306
"118","2020/07/16",262,4,5605,43,0.000207828855514487,9.7147475726665e-06,0.000114685932222357,26969306
"119","2020/07/17",484,10,6089,53,0.000225775183091474,1.7946327576987e-05,0.000124623154930275,26969306
"120","2020/07/18",378,1,6467,54,0.000239791116612344,1.401593352087e-05,0.000138639088451145,26969306
"121","2020/07/19",382,1,6849,55,0.000253955366890049,1.41642502777046e-05,0.000133448001961934,26969306
"122","2020/07/20",200,4,7049,59,0.000261371204731779,7.41583784173015e-06,0.000132632259799344,26969306
"123","2020/07/21",104,3,7153,62,0.000265227440409479,3.85623567769968e-06,0.00013274349736697,26969306
